0 ,0  ,0  ,0  ,0  ,0  ,0  ,0  ,0  ,0  ,0  ,0  ,0  ,0  ,0  ,0  ,0  ,0  ,0  ,0  ,0  ,0  ,0  ,0  ,0  ,0  ,0  ,0  ,0  ,0  ,0  ,0  ,0  ,0  ,0  ,0  ,0  ,0  ,0  ,0  ,0  ,0  ,0  ,0  ,0  ,0  ,0  ,0  ,0  ,0  ,0  ,0  ,0  ,0  ,0  ,0  ,0  ,0  ,0  ,0  ,0  ,0  ,0  ,0  ,0  ,0  ,0  ,0  ,0  ,0
0 ,0  ,0  ,0  ,0  ,0  ,0  ,0  ,0  ,0  ,0  ,0  ,0  ,0  ,0  ,0  ,0  ,0  ,-1 ,-1 ,-1 ,-1 ,-1 ,-1 ,-1 ,-1 ,-1 ,-1 ,0  ,0  ,0  ,0  ,0  ,0  ,0  ,0  ,0  ,0  ,0  ,0  ,0  ,0  ,0  ,0  ,0  ,0  ,0  ,0  ,0  ,0  ,0  ,0  ,0  ,0  ,0  ,0  ,0  ,0  ,0  ,0  ,0  ,0  ,0  ,0  ,0  ,0  ,0  ,0  ,0  ,0
0 ,0  ,0  ,0  ,0  ,-1 ,-1 ,-1 ,-1 ,-1 ,-1 ,-1 ,-1 ,-1 ,-1 ,-1 ,-1 ,-1 ,-1 ,-1 ,-1 ,-1 ,-1 ,-1 ,-1 ,-1 ,-1 ,-1 ,-1 ,-1 ,-1 ,-1 ,-1 ,-1 ,-1 ,-1 ,-1 ,-1 ,-1 ,0  ,0  ,0  ,0  ,0  ,0  ,0  ,0  ,0  ,0  ,0  ,0  ,0  ,0  ,0  ,0  ,0  ,0  ,0  ,0  ,0  ,0  ,0  ,0  ,0  ,0  ,0  ,0  ,0  ,0  ,0
0 ,0  ,0  ,0  ,0  ,-1 ,-1 ,-1 ,-1 ,-1 ,-1 ,-1 ,-1 ,-1 ,-1 ,-1 ,-1 ,-1 ,-1 ,-1 ,-1 ,-1 ,-1 ,-1 ,-1 ,-1 ,-1 ,-1 ,-1 ,-1 ,-1 ,-1 ,-1 ,-1 ,-1 ,-1 ,-1 ,-1 ,-1 ,-1 ,-1 ,-1 ,0  ,0  ,0  ,0  ,0  ,0  ,0  ,0  ,0  ,0  ,0  ,0  ,0  ,0  ,0  ,0  ,0  ,0  ,0  ,0  ,0  ,0  ,0  ,0  ,0  ,0  ,0  ,0
0 ,0  ,0  ,-1 ,-1 ,-1 ,-1 ,-1 ,-1 ,-1 ,-1 ,-1 ,-1 ,-1 ,-1 ,-1 ,-1 ,-1 ,-1 ,-1 ,-1 ,-1 ,-1 ,-1 ,-1 ,-1 ,-1 ,-1 ,-1 ,-1 ,-1 ,-1 ,-1 ,-1 ,-1 ,-1 ,-1 ,-1 ,-1 ,-1 ,-1 ,-1 ,-1 ,-1 ,0  ,0  ,0  ,0  ,0  ,0  ,0  ,0  ,0  ,0  ,0  ,0  ,0  ,0  ,0  ,0  ,0  ,0  ,0  ,0  ,0  ,0  ,0  ,0  ,0  ,0
0 ,0  ,-1 ,-1 ,-1 ,-1 ,-1 ,-1 ,-1 ,-1 ,-1 ,-1 ,-1 ,-1 ,-1 ,-1 ,-1 ,-1 ,-1 ,-1 ,-1 ,-1 ,-1 ,-1 ,-1 ,-1 ,-1 ,-1 ,-1 ,-1 ,-1 ,-1 ,-1 ,-1 ,-1 ,-1 ,-1 ,-1 ,-1 ,-1 ,-1 ,-1 ,-1 ,-1 ,1  ,6  ,5  ,0  ,0  ,0  ,0  ,0  ,0  ,0  ,0  ,0  ,0  ,0  ,0  ,0  ,0  ,0  ,0  ,0  ,0  ,0  ,0  ,0  ,0  ,0
0 ,0  ,-1 ,-1 ,-1 ,-1 ,-1 ,-1 ,-1 ,-1 ,-1 ,-1 ,-1 ,-1 ,-1 ,-1 ,-1 ,-1 ,-1 ,-1 ,-1 ,-1 ,-1 ,-1 ,-1 ,-1 ,-1 ,-1 ,-1 ,-1 ,-1 ,-1 ,-1 ,-1 ,-1 ,-1 ,-1 ,-1 ,-1 ,-1 ,-1 ,-1 ,-1 ,-1 ,-1 ,-1 ,-1 ,6  ,0  ,0  ,0  ,0  ,0  ,0  ,0  ,0  ,0  ,0  ,0  ,0  ,0  ,0  ,0  ,0  ,0  ,0  ,0  ,0  ,0  ,0
0 ,0  ,-1 ,-1 ,-1 ,-1 ,-1 ,-1 ,-1 ,-1 ,-1 ,-1 ,-1 ,-1 ,-1 ,-1 ,-1 ,-1 ,-1 ,-1 ,-1 ,-1 ,-1 ,-1 ,-1 ,-1 ,-1 ,-1 ,-1 ,-1 ,-1 ,-1 ,-1 ,-1 ,-1 ,-1 ,-1 ,-1 ,-1 ,-1 ,-1 ,-1 ,-1 ,-1 ,-1 ,-1 ,-1 ,-1 ,1  ,1  ,0  ,0  ,0  ,0  ,0  ,0  ,0  ,0  ,0  ,0  ,0  ,0  ,0  ,0  ,0  ,0  ,0  ,0  ,0  ,0
0 ,0  ,-1 ,-1 ,-1 ,-1 ,-1 ,-1 ,-1 ,-1 ,-1 ,-1 ,-1 ,-1 ,-1 ,-1 ,-1 ,-1 ,-1 ,-1 ,-1 ,-1 ,-1 ,-1 ,-1 ,-1 ,-1 ,-1 ,-1 ,-1 ,-1 ,-1 ,-1 ,-1 ,-1 ,-1 ,-1 ,-1 ,-1 ,-1 ,-1 ,-1 ,-1 ,-1 ,-1 ,-1 ,-1 ,-1 ,-1 ,-1 ,5  ,1  ,0  ,0  ,0  ,0  ,0  ,0  ,0  ,0  ,0  ,0  ,0  ,0  ,0  ,0  ,0  ,0  ,0  ,0
0 ,0  ,2  ,-1 ,-1 ,-1 ,-1 ,-1 ,-1 ,-1 ,-1 ,-1 ,-1 ,-1 ,-1 ,-1 ,-1 ,-1 ,-1 ,-1 ,-1 ,-1 ,-1 ,-1 ,-1 ,-1 ,-1 ,-1 ,-1 ,-1 ,-1 ,-1 ,-1 ,-1 ,-1 ,-1 ,-1 ,-1 ,-1 ,-1 ,-1 ,-1 ,-1 ,-1 ,-1 ,-1 ,-1 ,-1 ,-1 ,-1 ,-1 ,-1 ,5  ,0  ,0  ,0  ,0  ,0  ,0  ,0  ,0  ,0  ,0  ,0  ,0  ,0  ,0  ,0  ,0  ,0
0 ,0  ,0  ,7  ,2  ,-1 ,-1 ,-1 ,-1 ,-1 ,-1 ,-1 ,-1 ,-1 ,-1 ,-1 ,-1 ,-1 ,-1 ,-1 ,-1 ,-1 ,-1 ,-1 ,-1 ,-1 ,-1 ,-1 ,-1 ,-1 ,-1 ,-1 ,-1 ,-1 ,-1 ,-1 ,-1 ,-1 ,-1 ,-1 ,-1 ,-1 ,-1 ,-1 ,-1 ,-1 ,-1 ,-1 ,-1 ,-1 ,-1 ,-1 ,-1 ,6  ,6  ,0  ,0  ,0  ,0  ,0  ,0  ,0  ,0  ,0  ,0  ,0  ,0  ,0  ,0  ,0
0 ,0  ,0  ,0  ,0  ,7  ,10 ,10 ,2  ,2  ,-1 ,-1 ,-1 ,13 ,-1 ,-1 ,-1 ,16 ,16 ,16 ,16 ,16 ,-1 ,-1 ,-1 ,-1 ,-1 ,-1 ,-1 ,-1 ,-1 ,-1 ,-1 ,-1 ,-1 ,-1 ,-1 ,-1 ,-1 ,-1 ,-1 ,-1 ,-1 ,-1 ,-1 ,-1 ,-1 ,-1 ,-1 ,-1 ,-1 ,-1 ,-1 ,-1 ,-1 ,5  ,0  ,0  ,0  ,0  ,0  ,0  ,0  ,0  ,0  ,0  ,0  ,0  ,0  ,0
0 ,0  ,0  ,0  ,0  ,0  ,0  ,0  ,0  ,0  ,0  ,0  ,0  ,0  ,0  ,-1 ,-1 ,16 ,-1 ,-1 ,-1 ,16 ,-1 ,-1 ,-1 ,-1 ,-1 ,-1 ,-1 ,-1 ,-1 ,-1 ,-1 ,-1 ,-1 ,-1 ,-1 ,-1 ,-1 ,-1 ,-1 ,-1 ,-1 ,-1 ,-1 ,-1 ,-1 ,-1 ,-1 ,-1 ,-1 ,-1 ,-1 ,-1 ,-1 ,-1 ,1  ,0  ,0  ,0  ,0  ,0  ,0  ,0  ,0  ,0  ,0  ,0  ,0  ,0
0 ,0  ,0  ,0  ,0  ,0  ,0  ,0  ,0  ,0  ,0  ,0  ,0  ,0  ,0  ,0  ,0  ,0  ,11 ,11 ,-1 ,16 ,-1 ,-1 ,-1 ,-1 ,-1 ,-1 ,-1 ,-1 ,-1 ,-1 ,-1 ,-1 ,-1 ,-1 ,-1 ,-1 ,-1 ,-1 ,-1 ,-1 ,-1 ,-1 ,-1 ,-1 ,-1 ,-1 ,-1 ,-1 ,-1 ,-1 ,-1 ,-1 ,-1 ,-1 ,-1 ,1  ,0  ,0  ,0  ,0  ,0  ,0  ,0  ,0  ,0  ,0  ,0  ,0
0 ,0  ,0  ,0  ,0  ,0  ,0  ,0  ,0  ,0  ,0  ,0  ,0  ,0  ,0  ,0  ,0  ,0  ,0  ,0  ,0  ,16 ,-1 ,-1 ,-1 ,-1 ,-1 ,-1 ,-1 ,-1 ,-1 ,-1 ,-1 ,-1 ,-1 ,-1 ,-1 ,-1 ,-1 ,-1 ,-1 ,-1 ,-1 ,-1 ,-1 ,-1 ,-1 ,-1 ,-1 ,-1 ,-1 ,-1 ,-1 ,-1 ,-1 ,-1 ,-1 ,-1 ,1  ,0  ,0  ,0  ,0  ,0  ,0  ,0  ,0  ,0  ,0  ,0
0 ,0  ,0  ,0  ,0  ,0  ,0  ,0  ,0  ,0  ,0  ,0  ,0  ,0  ,0  ,0  ,0  ,0  ,0  ,0  ,0  ,-1 ,-1 ,-1 ,-1 ,-1 ,-1 ,-1 ,-1 ,-1 ,-1 ,-1 ,-1 ,-1 ,-1 ,-1 ,-1 ,-1 ,-1 ,-1 ,-1 ,-1 ,-1 ,-1 ,-1 ,-1 ,-1 ,-1 ,-1 ,-1 ,-1 ,-1 ,-1 ,-1 ,-1 ,-1 ,-1 ,-1 ,-1 ,6  ,0  ,0  ,0  ,0  ,0  ,0  ,0  ,0  ,0  ,0
0 ,0  ,0  ,0  ,0  ,0  ,0  ,0  ,0  ,0  ,0  ,0  ,0  ,0  ,0  ,0  ,0  ,5  ,6  ,6  ,1  ,-1 ,-1 ,-1 ,-1 ,-1 ,-1 ,0  ,-1 ,-1 ,-1 ,-1 ,-1 ,-1 ,-1 ,-1 ,-1 ,-1 ,-1 ,-1 ,-1 ,-1 ,-1 ,-1 ,-1 ,-1 ,-1 ,-1 ,-1 ,-1 ,-1 ,-1 ,-1 ,-1 ,-1 ,-1 ,4  ,-1 ,-1 ,-1 ,5  ,0  ,0  ,0  ,0  ,0  ,0  ,0  ,0  ,0
0 ,0  ,0  ,0  ,0  ,0  ,0  ,0  ,0  ,0  ,5  ,1  ,1  ,6  ,5  ,1  ,1  ,-1 ,-1 ,-1 ,-1 ,-1 ,-1 ,-1 ,-1 ,-1 ,-1 ,-1 ,-1 ,-1 ,-1 ,-1 ,-1 ,-1 ,-1 ,-1 ,-1 ,-1 ,-1 ,-1 ,-1 ,-1 ,-1 ,-1 ,-1 ,-1 ,-1 ,-1 ,-1 ,-1 ,-1 ,-1 ,-1 ,-1 ,-1 ,-1 ,17 ,-1 ,-1 ,-1 ,-1 ,6  ,0  ,0  ,0  ,0  ,0  ,0  ,0  ,0
0 ,0  ,0  ,0  ,0  ,0  ,0  ,1  ,5  ,1  ,-1 ,-1 ,-1 ,-1 ,-1 ,-1 ,-1 ,-1 ,-1 ,-1 ,-1 ,-1 ,-1 ,-1 ,-1 ,-1 ,-1 ,-1 ,-1 ,-1 ,-1 ,0  ,-1 ,-1 ,-1 ,-1 ,-1 ,-1 ,-1 ,-1 ,-1 ,-1 ,-1 ,-1 ,-1 ,-1 ,-1 ,-1 ,-1 ,-1 ,-1 ,-1 ,-1 ,-1 ,-1 ,-1 ,17 ,-1 ,-1 ,-1 ,-1 ,-1 ,6  ,0  ,0  ,0  ,0  ,0  ,0  ,0
0 ,0  ,0  ,0  ,0  ,6  ,6  ,-1 ,-1 ,-1 ,-1 ,-1 ,-1 ,-1 ,-1 ,-1 ,-1 ,-1 ,-1 ,-1 ,-1 ,-1 ,-1 ,-1 ,-1 ,-1 ,-1 ,-1 ,-1 ,-1 ,-1 ,-1 ,-1 ,-1 ,-1 ,-1 ,-1 ,-1 ,-1 ,-1 ,-1 ,-1 ,-1 ,-1 ,-1 ,-1 ,-1 ,-1 ,-1 ,-1 ,-1 ,-1 ,-1 ,-1 ,-1 ,-1 ,17 ,-1 ,-1 ,-1 ,-1 ,-1 ,-1 ,5  ,0  ,0  ,0  ,0  ,0  ,0
0 ,0  ,0  ,6  ,6  ,-1 ,-1 ,-1 ,-1 ,-1 ,-1 ,-1 ,-1 ,-1 ,-1 ,-1 ,-1 ,-1 ,-1 ,-1 ,-1 ,-1 ,-1 ,-1 ,-1 ,-1 ,-1 ,-1 ,-1 ,-1 ,0  ,-1 ,-1 ,-1 ,-1 ,-1 ,-1 ,-1 ,-1 ,-1 ,-1 ,-1 ,-1 ,-1 ,-1 ,-1 ,-1 ,-1 ,-1 ,-1 ,-1 ,-1 ,-1 ,-1 ,-1 ,-1 ,17 ,-1 ,-1 ,-1 ,-1 ,-1 ,-1 ,-1 ,0  ,0  ,0  ,0  ,0  ,0
0 ,0  ,5  ,-1 ,-1 ,-1 ,-1 ,-1 ,-1 ,-1 ,-1 ,-1 ,-1 ,-1 ,-1 ,-1 ,-1 ,-1 ,-1 ,-1 ,-1 ,-1 ,-1 ,17 ,17 ,17 ,17 ,17 ,18 ,17 ,17 ,17 ,17 ,-1 ,-1 ,-1 ,-1 ,-1 ,-1 ,-1 ,-1 ,-1 ,-1 ,-1 ,-1 ,-1 ,-1 ,-1 ,-1 ,-1 ,-1 ,-1 ,-1 ,-1 ,-1 ,-1 ,17 ,-1 ,-1 ,-1 ,-1 ,-1 ,-1 ,-1 ,5  ,0  ,0  ,0  ,0  ,0
0 ,6  ,-1 ,-1 ,-1 ,-1 ,-1 ,-1 ,-1 ,-1 ,-1 ,-1 ,-1 ,-1 ,-1 ,-1 ,-1 ,-1 ,-1 ,-1 ,-1 ,-1 ,-1 ,-1 ,-1 ,-1 ,-1 ,-1 ,-1 ,-1 ,-1 ,-1 ,-1 ,0  ,-1 ,-1 ,-1 ,-1 ,-1 ,-1 ,-1 ,-1 ,-1 ,-1 ,-1 ,-1 ,-1 ,-1 ,-1 ,-1 ,-1 ,-1 ,-1 ,-1 ,-1 ,-1 ,17 ,-1 ,-1 ,-1 ,-1 ,-1 ,-1 ,-1 ,-1 ,1  ,0  ,0  ,0  ,0
0 ,-1 ,-1 ,-1 ,-1 ,-1 ,-1 ,-1 ,-1 ,-1 ,-1 ,-1 ,-1 ,-1 ,-1 ,-1 ,-1 ,-1 ,-1 ,-1 ,-1 ,-1 ,-1 ,-1 ,-1 ,-1 ,17 ,-1 ,-1 ,-1 ,-1 ,-1 ,0  ,-1 ,-1 ,-1 ,-1 ,-1 ,-1 ,-1 ,-1 ,-1 ,-1 ,-1 ,-1 ,-1 ,-1 ,-1 ,-1 ,-1 ,-1 ,-1 ,-1 ,-1 ,-1 ,-1 ,17 ,-1 ,-1 ,-1 ,-1 ,-1 ,-1 ,-1 ,-1 ,-1 ,0  ,0  ,0  ,0
0 ,-1 ,-1 ,-1 ,-1 ,-1 ,-1 ,-1 ,-1 ,-1 ,-1 ,-1 ,-1 ,-1 ,-1 ,-1 ,-1 ,-1 ,-1 ,-1 ,-1 ,-1 ,-1 ,-1 ,-1 ,-1 ,17 ,-1 ,-1 ,-1 ,-1 ,-1 ,-1 ,-1 ,-1 ,-1 ,-1 ,-1 ,-1 ,-1 ,-1 ,-1 ,-1 ,-1 ,-1 ,-1 ,-1 ,-1 ,-1 ,-1 ,-1 ,-1 ,-1 ,-1 ,-1 ,-1 ,17 ,-1 ,-1 ,-1 ,-1 ,-1 ,-1 ,-1 ,-1 ,-1 ,6  ,0  ,0  ,0
0 ,-1 ,-1 ,-1 ,-1 ,-1 ,-1 ,-1 ,-1 ,-1 ,-1 ,-1 ,-1 ,-1 ,-1 ,-1 ,-1 ,-1 ,-1 ,-1 ,-1 ,-1 ,-1 ,3  ,-1 ,-1 ,17 ,-1 ,-1 ,-1 ,0  ,-1 ,-1 ,-1 ,-1 ,-1 ,-1 ,-1 ,-1 ,-1 ,-1 ,-1 ,-1 ,-1 ,-1 ,-1 ,-1 ,-1 ,-1 ,-1 ,-1 ,-1 ,-1 ,-1 ,-1 ,-1 ,17 ,-1 ,-1 ,-1 ,-1 ,-1 ,-1 ,-1 ,-1 ,-1 ,-1 ,0  ,0  ,0
0 ,-1 ,-1 ,-1 ,-1 ,-1 ,-1 ,-1 ,-1 ,-1 ,-1 ,-1 ,-1 ,-1 ,-1 ,-1 ,-1 ,-1 ,-1 ,-1 ,-1 ,-1 ,-1 ,0  ,-1 ,-1 ,17 ,0  ,0  ,0  ,5  ,-1 ,-1 ,-1 ,-1 ,-1 ,-1 ,-1 ,-1 ,-1 ,-1 ,-1 ,-1 ,-1 ,-1 ,-1 ,-1 ,-1 ,-1 ,-1 ,-1 ,-1 ,-1 ,-1 ,-1 ,-1 ,17 ,-1 ,-1 ,-1 ,-1 ,-1 ,-1 ,-1 ,-1 ,-1 ,-1 ,1  ,0  ,0
0 ,-1 ,-1 ,-1 ,-1 ,-1 ,-1 ,-1 ,-1 ,-1 ,-1 ,-1 ,-1 ,-1 ,-1 ,-1 ,-1 ,-1 ,-1 ,-1 ,-1 ,-1 ,-1 ,-1 ,0  ,0  ,17 ,-1 ,-1 ,-1 ,-1 ,-1 ,0  ,-1 ,-1 ,-1 ,-1 ,-1 ,-1 ,-1 ,-1 ,-1 ,-1 ,-1 ,-1 ,-1 ,-1 ,-1 ,-1 ,-1 ,-1 ,-1 ,-1 ,-1 ,-1 ,-1 ,17 ,-1 ,-1 ,-1 ,-1 ,-1 ,-1 ,-1 ,-1 ,-1 ,-1 ,-1 ,0  ,0
0 ,-1 ,-1 ,-1 ,-1 ,-1 ,-1 ,-1 ,-1 ,-1 ,-1 ,-1 ,-1 ,-1 ,-1 ,-1 ,-1 ,-1 ,-1 ,-1 ,-1 ,-1 ,-1 ,-1 ,-1 ,-1 ,17 ,-1 ,-1 ,-1 ,-1 ,-1 ,1  ,7  ,-1 ,-1 ,-1 ,-1 ,-1 ,-1 ,-1 ,-1 ,-1 ,-1 ,-1 ,-1 ,-1 ,-1 ,-1 ,-1 ,-1 ,-1 ,-1 ,-1 ,-1 ,-1 ,17 ,-1 ,-1 ,-1 ,-1 ,-1 ,-1 ,-1 ,-1 ,-1 ,-1 ,-1 ,0  ,0
0 ,-1 ,-1 ,-1 ,-1 ,-1 ,-1 ,-1 ,-1 ,-1 ,-1 ,-1 ,-1 ,-1 ,-1 ,-1 ,-3 ,-1 ,-1 ,-1 ,-1 ,-1 ,-1 ,-1 ,-1 ,-1 ,4  ,-1 ,-1 ,-1 ,-1 ,-1 ,-1 ,0  ,-1 ,-1 ,-1 ,-1 ,-1 ,-1 ,-1 ,-1 ,-1 ,-1 ,-1 ,-1 ,-1 ,-1 ,-1 ,-1 ,-1 ,-1 ,-1 ,-1 ,-1 ,-1 ,17 ,-1 ,-1 ,-1 ,-1 ,-1 ,-1 ,-1 ,-1 ,-1 ,-1 ,-1 ,5  ,0
0 ,-1 ,-2 ,-1 ,-1 ,-1 ,-1 ,0  ,0  ,0  ,0  ,0  ,0  ,0  ,0  ,0  ,0  ,-1 ,-1 ,-1 ,11 ,-1 ,-1 ,-1 ,-1 ,-1 ,-1 ,-1 ,-1 ,-1 ,-1 ,-1 ,-1 ,-1 ,-1 ,-1 ,-1 ,-1 ,-1 ,-1 ,-1 ,-1 ,-1 ,-1 ,-1 ,-1 ,-1 ,-1 ,-1 ,-1 ,-1 ,-1 ,-1 ,-1 ,-1 ,-1 ,-1 ,-1 ,-1 ,-1 ,-1 ,-1 ,-1 ,-1 ,-1 ,-1 ,-1 ,-1 ,-1 ,0
0 ,0  ,0  ,0  ,0  ,0  ,0  ,0  ,0  ,0  ,0  ,0  ,0  ,0  ,0  ,0  ,0  ,0  ,0  ,0  ,0  ,0  ,0  ,16 ,16 ,16 ,-1 ,-1 ,-1 ,-1 ,-1 ,-1 ,-1 ,-1 ,-1 ,-1 ,0  ,0  ,0  ,-1 ,-1 ,-1 ,-1 ,-1 ,-1 ,-1 ,-1 ,-1 ,-1 ,-1 ,-1 ,-1 ,-1 ,-1 ,-1 ,-1 ,-1 ,-1 ,-1 ,-1 ,-1 ,-1 ,-1 ,-1 ,-1 ,-1 ,-1 ,-1 ,-1 ,0
0 ,0  ,0  ,0  ,0  ,0  ,0  ,0  ,0  ,0  ,0  ,0  ,0  ,0  ,0  ,0  ,0  ,0  ,0  ,0  ,0  ,0  ,0  ,0  ,0  ,8  ,-1 ,-1 ,-1 ,-1 ,-1 ,-1 ,-1 ,-1 ,-1 ,-1 ,-1 ,-1 ,1  ,-1 ,-1 ,-1 ,-1 ,-1 ,-1 ,-1 ,-1 ,-1 ,-1 ,-1 ,-1 ,-1 ,-1 ,-1 ,-1 ,-1 ,-1 ,-1 ,-1 ,-1 ,-1 ,-1 ,-1 ,-1 ,-1 ,-1 ,-1 ,3  ,8  ,0
0 ,0  ,0  ,0  ,0  ,0  ,0  ,0  ,0  ,0  ,0  ,0  ,0  ,0  ,0  ,0  ,0  ,0  ,0  ,0  ,0  ,0  ,0  ,0  ,0  ,0  ,0  ,0  ,0  ,0  ,0  ,8  ,8  ,8  ,8  ,8  ,8  ,8  ,-1 ,-1 ,-1 ,-1 ,-1 ,-1 ,-1 ,-1 ,-1 ,-1 ,-1 ,-1 ,-1 ,-1 ,-1 ,-1 ,-1 ,-1 ,-1 ,-1 ,-1 ,-1 ,-1 ,-1 ,-1 ,-1 ,0  ,0  ,0  ,0  ,0  ,0
0 ,0  ,0  ,0  ,0  ,0  ,0  ,0  ,0  ,0  ,0  ,0  ,0  ,0  ,0  ,0  ,0  ,0  ,0  ,0  ,0  ,0  ,0  ,0  ,0  ,0  ,0  ,0  ,0  ,0  ,0  ,0  ,0  ,0  ,0  ,0  ,0  ,0  ,0  ,0  ,8  ,-1 ,-1 ,-1 ,-1 ,-1 ,-1 ,-1 ,-1 ,-1 ,-1 ,-1 ,-1 ,-1 ,-1 ,-1 ,-1 ,-1 ,-1 ,-1 ,-1 ,-1 ,-1 ,-1 ,0  ,0  ,0  ,0  ,0  ,0
0 ,0  ,0  ,0  ,0  ,0  ,0  ,0  ,0  ,0  ,0  ,0  ,0  ,0  ,0  ,0  ,0  ,0  ,0  ,0  ,0  ,0  ,0  ,0  ,0  ,0  ,0  ,0  ,0  ,0  ,0  ,0  ,0  ,0  ,0  ,0  ,0  ,0  ,0  ,0  ,0  ,0  ,-1 ,-1 ,-1 ,-1 ,-1 ,-1 ,-1 ,-1 ,-1 ,-1 ,-1 ,-1 ,-1 ,-1 ,-1 ,-1 ,-1 ,-1 ,-1 ,-1 ,-1 ,-1 ,0  ,0  ,0  ,0  ,0  ,0
0 ,0  ,0  ,0  ,0  ,0  ,0  ,0  ,0  ,0  ,0  ,0  ,0  ,0  ,0  ,0  ,0  ,0  ,0  ,0  ,0  ,0  ,0  ,0  ,0  ,0  ,0  ,0  ,0  ,0  ,0  ,0  ,0  ,0  ,0  ,0  ,0  ,0  ,0  ,0  ,0  ,0  ,-1 ,-1 ,-1 ,-1 ,-1 ,-1 ,-1 ,-1 ,-1 ,-1 ,-1 ,-1 ,-1 ,-1 ,-1 ,-1 ,-1 ,-1 ,-1 ,-1 ,-1 ,-1 ,-1 ,-1 ,-1 ,0  ,0  ,0
0 ,0  ,0  ,0  ,0  ,0  ,0  ,0  ,0  ,0  ,0  ,0  ,0  ,0  ,0  ,0  ,0  ,0  ,0  ,0  ,0  ,0  ,0  ,0  ,0  ,0  ,0  ,0  ,0  ,0  ,0  ,0  ,0  ,0  ,0  ,0  ,0  ,0  ,0  ,0  ,0  ,0  ,0  ,0  ,0  ,15 ,15 ,15 ,15 ,15 ,15 ,15 ,15 ,15 ,15 ,15 ,15 ,15 ,15 ,15 ,15 ,15 ,15 ,15 ,15 ,15 ,15 ,15 ,15 ,0
0 ,0  ,0  ,0  ,0  ,0  ,0  ,0  ,0  ,0  ,0  ,0  ,0  ,0  ,0  ,0  ,0  ,0  ,0  ,0  ,0  ,0  ,0  ,0  ,0  ,0  ,0  ,0  ,0  ,0  ,0  ,0  ,0  ,0  ,0  ,0  ,0  ,0  ,0  ,0  ,0  ,0  ,0  ,0  ,0  ,15 ,15 ,15 ,15 ,15 ,15 ,15 ,15 ,15 ,15 ,15 ,15 ,15 ,15 ,15 ,15 ,15 ,15 ,15 ,15 ,15 ,15 ,15 ,15 ,0
0 ,0  ,0  ,0  ,0  ,0  ,0  ,0  ,0  ,0  ,0  ,0  ,0  ,0  ,0  ,0  ,0  ,0  ,0  ,0  ,0  ,0  ,0  ,0  ,0  ,0  ,0  ,0  ,0  ,0  ,0  ,0  ,0  ,0  ,0  ,0  ,0  ,0  ,0  ,0  ,0  ,0  ,0  ,0  ,0  ,0  ,0  ,0  ,0  ,0  ,0  ,0  ,0  ,0  ,0  ,0  ,0  ,0  ,0  ,0  ,0  ,0  ,0  ,0  ,0  ,0  ,0  ,0  ,0  ,0
