7 ,7  ,7  ,7  ,7  ,7  ,7  ,7  ,7  ,7  ,7  ,7  ,7  ,7  ,7  ,7  ,7  ,7  ,7  ,7  ,7  ,7  ,7  ,7  ,7  ,7  ,7  ,7  ,7  ,7  ,7  ,7  ,7  ,7  ,7  ,7  ,7  ,7  ,7  ,7  ,7  ,7  ,7  ,7  ,7  ,7  ,7  ,7  ,7 ,7
7 ,7  ,7  ,7  ,7  ,7  ,7  ,7  ,7  ,7  ,-1 ,-1 ,-1 ,-1 ,-1 ,-1 ,4  ,6  ,5  ,6  ,5  ,4  ,6  ,4  ,6  ,5  ,5  ,5  ,5  ,5  ,5  ,4  ,6  ,4  ,5  ,7  ,7  ,7  ,7  ,7  ,7  ,7  ,7  ,7  ,7  ,7  ,7  ,7  ,7 ,7
7 ,7  ,7  ,7  ,7  ,7  ,6  ,6  ,4  ,6  ,-1 ,-1 ,-1 ,-1 ,-1 ,-1 ,-1 ,-1 ,-1 ,-1 ,-1 ,-1 ,-1 ,-1 ,-1 ,-1 ,-1 ,-1 ,-1 ,-1 ,-1 ,-1 ,-1 ,-1 ,-1 ,4  ,6  ,6  ,4  ,6  ,7  ,7  ,7  ,7  ,7  ,7  ,7  ,7  ,7 ,7
7 ,4  ,7  ,7  ,5  ,6  ,-1 ,-1 ,-1 ,-1 ,-1 ,-1 ,-1 ,-1 ,-1 ,-1 ,-1 ,-1 ,-1 ,-1 ,-1 ,-1 ,-1 ,-1 ,-1 ,-1 ,-1 ,-1 ,-1 ,-1 ,-1 ,-1 ,-1 ,-1 ,-1 ,-1 ,-1 ,-1 ,-1 ,-1 ,6  ,5  ,6  ,5  ,7  ,7  ,7  ,7  ,7 ,7
7 ,-1 ,5  ,7  ,-1 ,8  ,-1 ,-1 ,-1 ,-1 ,-1 ,-1 ,-1 ,-1 ,-1 ,-1 ,-1 ,-1 ,-1 ,-1 ,-1 ,-1 ,-1 ,-1 ,-1 ,-1 ,-1 ,-1 ,-1 ,-1 ,-1 ,-1 ,-1 ,-1 ,-1 ,-1 ,-1 ,-1 ,-1 ,-1 ,-1 ,-1 ,-1 ,-1 ,4  ,7  ,7  ,7  ,7 ,7
7 ,-1 ,-1 ,7  ,7  ,7  ,7  ,-1 ,-1 ,-1 ,-1 ,-1 ,-1 ,-1 ,-1 ,-1 ,-1 ,-1 ,-1 ,-1 ,-1 ,-1 ,-1 ,-1 ,-1 ,-1 ,-1 ,-1 ,-1 ,-1 ,-1 ,-1 ,-1 ,-1 ,-1 ,-1 ,-1 ,-1 ,-1 ,-1 ,-1 ,-1 ,-1 ,-1 ,-1 ,5  ,7  ,7  ,7 ,7
7 ,-1 ,-1 ,-1 ,-1 ,-1 ,-1 ,-1 ,-1 ,-1 ,-1 ,-1 ,-1 ,-1 ,-1 ,-1 ,-1 ,-1 ,-1 ,7  ,-1 ,-1 ,-1 ,-1 ,-1 ,-1 ,-1 ,-1 ,-1 ,-1 ,-1 ,-1 ,-1 ,-1 ,-1 ,-1 ,-1 ,-1 ,-1 ,-1 ,-1 ,-1 ,-1 ,-1 ,-1 ,-1 ,5  ,7  ,7 ,7
7 ,-1 ,-1 ,-1 ,-1 ,-1 ,-1 ,-1 ,-1 ,7  ,7  ,7  ,-1 ,-1 ,-1 ,-1 ,-1 ,-1 ,-1 ,-1 ,-1 ,-1 ,-1 ,-1 ,-1 ,-1 ,-1 ,-1 ,-1 ,-1 ,-1 ,-1 ,-1 ,-1 ,-1 ,-1 ,-1 ,-1 ,-1 ,-1 ,-1 ,-1 ,-1 ,-1 ,-1 ,-1 ,-1 ,7  ,7 ,7
7 ,-1 ,-1 ,-1 ,-1 ,-1 ,-1 ,-1 ,-1 ,-1 ,-1 ,-1 ,-1 ,-1 ,-1 ,-1 ,3  ,-1 ,-1 ,-1 ,-1 ,-1 ,7  ,-1 ,-1 ,-1 ,-1 ,-1 ,-1 ,-1 ,-1 ,-1 ,-1 ,-1 ,-1 ,-1 ,-1 ,-1 ,-1 ,-1 ,-1 ,-1 ,-1 ,-1 ,-1 ,-1 ,-1 ,6  ,7 ,7
7 ,-1 ,-1 ,-1 ,-1 ,-1 ,-1 ,-1 ,-1 ,-1 ,-1 ,-1 ,-1 ,-1 ,7  ,-1 ,7  ,-1 ,-1 ,-1 ,-1 ,-1 ,7  ,-1 ,2  ,2  ,2  ,3  ,2  ,-1 ,-1 ,7  ,-1 ,-1 ,-1 ,-1 ,-1 ,-1 ,-1 ,-1 ,-1 ,-1 ,-1 ,-1 ,-1 ,-1 ,-1 ,-1 ,7 ,7
7 ,-1 ,-1 ,-1 ,-1 ,-1 ,-1 ,-1 ,-1 ,-1 ,-1 ,-1 ,-1 ,-1 ,-1 ,-1 ,-1 ,-1 ,-1 ,-1 ,-1 ,-1 ,7  ,-1 ,7  ,7  ,7  ,7  ,7  ,-1 ,-1 ,-1 ,-1 ,-1 ,-1 ,-1 ,-1 ,-1 ,-1 ,-1 ,-1 ,-1 ,-1 ,-1 ,-1 ,0  ,2  ,2  ,7 ,7
7 ,-1 ,-1 ,-1 ,-1 ,-1 ,-1 ,-1 ,-1 ,-1 ,-1 ,-1 ,-1 ,-1 ,-1 ,-1 ,-1 ,-1 ,-1 ,-1 ,-1 ,-1 ,-1 ,-1 ,-1 ,-1 ,-1 ,-1 ,-1 ,-1 ,-1 ,-1 ,-1 ,7  ,-1 ,-1 ,-1 ,-1 ,-1 ,-1 ,-1 ,-1 ,-3  ,-1 ,7  ,7  ,7  ,7  ,7 ,7
7 ,-1 ,-1 ,-1 ,-1 ,-1 ,-1 ,-1 ,-1 ,-1 ,-1 ,-1 ,-1 ,-1 ,-1 ,-1 ,-1 ,-1 ,-1 ,-1 ,-1 ,-1 ,-1 ,-1 ,-1 ,-1 ,-1 ,-1 ,-1 ,-1 ,-1 ,7  ,7  ,-1 ,-1 ,-1 ,-1 ,-1 ,-1 ,2  ,7  ,7  ,7  ,7  ,7  ,7  ,7  ,7  ,7 ,7
7 ,-1 ,-1 ,-1 ,-1 ,-1 ,-1 ,-1 ,-1 ,-1 ,-1 ,-1 ,-1 ,-1 ,-1 ,-1 ,-1 ,-1 ,-1 ,-1 ,-1 ,-1 ,-1 ,-1 ,-1 ,-1 ,-1 ,-1 ,-1 ,-1 ,-1 ,-1 ,-1 ,-1 ,-1 ,-1 ,-1 ,-1 ,7  ,7  ,7  ,7  ,7  ,7  ,7  ,7  ,7  ,7  ,7 ,7
7 ,-2  ,1  ,1  ,1  ,1  ,1  ,1  ,1  ,2  ,1  ,2  ,1  ,1  ,0  ,-1 ,-1 ,-1 ,-1 ,-1 ,-1 ,-1 ,-1 ,-1 ,-1 ,-1 ,-1 ,7  ,7  ,-1 ,-1 ,-1 ,-1 ,-1 ,-1 ,-1 ,-1 ,-1 ,5  ,6  ,6  ,6  ,6  ,5  ,5  ,5  ,6  ,6  ,7 ,7
7 ,7  ,7  ,7  ,7  ,7  ,7  ,7  ,7  ,7  ,7  ,7  ,7  ,7  ,7  ,2  ,0  ,1  ,1  ,0  ,1  ,-1 ,-1 ,-1 ,-1 ,-1 ,-1 ,-1 ,-1 ,-1 ,-1 ,-1 ,-1 ,-1 ,-1 ,-1 ,-1 ,-1 ,-1 ,-1 ,-1 ,-1 ,-1 ,-1 ,-1 ,-1 ,-1 ,3  ,7 ,7
7 ,7  ,7  ,7  ,7  ,7  ,7  ,7  ,7  ,7  ,7  ,7  ,7  ,7  ,7  ,7  ,7  ,7  ,7  ,7  ,7  ,0  ,2  ,0  ,0  ,-1 ,-1 ,-1 ,-1 ,-1 ,-1 ,-1 ,-1 ,-1 ,-1 ,-1 ,-1 ,-1 ,-1 ,-1 ,-1 ,-1 ,-1 ,-1 ,-1 ,-1 ,-1 ,7  ,7 ,7
7 ,7  ,7  ,7  ,7  ,7  ,7  ,7  ,7  ,7  ,7  ,7  ,7  ,7  ,7  ,7  ,7  ,7  ,7  ,7  ,7  ,7  ,7  ,7  ,7  ,2  ,2  ,2  ,1  ,2  ,2  ,-1 ,-1 ,-1 ,-1 ,-1 ,-1 ,-1 ,-1 ,-1 ,-1 ,-1 ,-1 ,-1 ,-1 ,-1 ,-1 ,7  ,7 ,7
7 ,7  ,7  ,7  ,7  ,7  ,7  ,7  ,7  ,7  ,7  ,7  ,7  ,7  ,7  ,7  ,7  ,7  ,7  ,7  ,7  ,7  ,7  ,7  ,7  ,7  ,7  ,7  ,7  ,7  ,7  ,2  ,1  ,0  ,1  ,2  ,0  ,1  ,2  ,0  ,2  ,0  ,2  ,3  ,3  ,3  ,3  ,7  ,7 ,7
7 ,7  ,7  ,7  ,7  ,7  ,7  ,7  ,7  ,7  ,7  ,7  ,7  ,7  ,7  ,7  ,7  ,7  ,7  ,7  ,7  ,7  ,7  ,7  ,7  ,7  ,7  ,7  ,7  ,7  ,7  ,7  ,7  ,7  ,7  ,7  ,7  ,7  ,7  ,7  ,7  ,7  ,7  ,7  ,7  ,7  ,7  ,7  ,7 ,7
